L D L R L D L D L D L D L D R D L D
D L D R D L D L D L D L D L R L D L
L D L R L D L D L D L D L D R D L D
D L D R D L D L D L D L D L R L D L
L D L R L D L D L D L D L D R D L D
D L D R D L D L D L D L D L R L D L
L D L R L D L D L D L D L D R D L D
D L D R D L D L D L D L D L R L D L
L D L R L D L D L D L D L D R D L D
D L D R D L D L D L D L D L R L D L
L D L R L D L D L D L D L D R D L D
D L D R D L D L D L D L D L R L D L
L D L R L D L D L D L D L D R D L D
D L D R D L D L D L D L D L R L D L
L D L R L D L D L D L D L D R D L D
W W W B W W W W W W W W W W B W W W
W W W B W W W W W W W W W W B W W W
L D L R L D L D L D L D L D R D L D
D L D R D L D L D L D L D L R L D L
L D L R L D L D L D L D L D R D L D
D L D R D L D L D L D L D L R L D L
L D L R L D L D L D L D L D R D L D
D L D R D L D L D L D L D L R L D L
L D L R L D L D L D L D L D R D L D
D L D R D L D L D L D L D L R L D L
L D L R L D L D L D L D L D R D L D
D L D R D L D L D L D L D L R L D L
L D L R L D L D L D L D L D R D L D
D L D R D L D L D L D L D L R L D L
L D L R L D L D L D L D L D R D L D
D L D R D L D L D L D L D L R L D L
L D L R L D L D L D L D L D R D L D