L D L R L D R R R R R R L D R D L D
D L D R D L R R R R R R D L R L D L
L D L R L D L D L D L D L D R D L D
D R R R R R D L D L D L R R R R R L
L R L R L R L D L D L D R D R D R D
D R D R D R D L D L D L R L R L R L
L R L R L R L D L D L D R D R D R D
D R R R R R D L D L D L R R R R R L
L D L R L D L D L D L D L D R D L D
D L D R D L D L D L D L D L R L D L
L D L R L D L D L D L D L D R D L D
D L D R D L D L D L D L D L R L D L
L D L R L D L D L D L D L D R D L D
D L D R D L D L D L D L D L R L D L
L D L R L D L D L D L D L D R D L D
W W W B W W W W W W W W W W B W W W
W W W B W W W W W W W W W W B W W W
L D L R L D L D L D L D L D R D L D
D L D R D L D L D L D L D L R L D L
L D L R L D L D L D L D L D R D L D
D L D R D L D L D L D L D L R L D L
L D L R L D L D L D L D L D R D L D
D L D R D L D L D L D L D L R L D L
L D L R L D L D L D L D L D R D L D
D R R R R R D L D L D L R R R R R L
L R L R L R L D L D L D R D R D R D
D R D R D R D L D L D L R L R L R L
L R L R L R L D L D L D R D R D R D
D R R R R R D L D L D L R R R R R L
L D L R L D L D L D L D L D R D L D
D L D R D L R R R R R R D L R L D L
L D L R L D R R R R R R L D R D L D